WWWWWWWWWW
WWWWRCWWWW
WWWCCCCWWW
WWCCCCCCWW
WCCCCCCCCW
WCCCCCCCTW
WWCCCCCCWW
WWWCCCCWWW
WWWWCCWWWW
WWWWWWWWWW