RCCCCCCCCC
CWWWWWWWWC
CWWTCWWWWC
CWWWCCWWWC
CWWWWCCWWC
CWWWWWCCWC
CWWWWWWCCC
CCCCCCCCCC